10 200
3333333333333333333333333333333333333333333333333333333333333333333333333333333333333333333333333333333333333333333333333333333333333333333333333333333333333333333333333333333333333333333333333333333                              
3010000000000000000000000000000011000000000000000000000000000000000000000000010000000000000000010000000000000000000000000000000000000000111000000000000000000000000000000000000000000000000000000000003
3010000000000000000000000000000001000000000000000000000000000000000000000000010000000000000000010000000000000000000000000000000000011111111111100000000000000000000000000000000000001111111110000000003
3100000000000000000000000000000000000000000000000000000000000000000000000000000001000000000000001000000000000000000000000000000000000011111100000000000000000000000000000000000000000001111100000000003
3100000000000000000000000000000000000000000000011110000000000000000000000000000000000000000000000100000000000000000000000000000000000000000000000000000000000000000000000000000000000000000000000000013
3100000000000000000000000000000000000000000001110001100000000000000000000000010000000000000000000010000100000000000000000000000000000000000000000000000000000000000000000000000000000000000000000111003
3000000000000000000000000000000000000000000111000000011000000000000000000000000000001000000000000000100000000000000000000000000000000000000000000000000011100000000000000000000000000000000000000100003
3000000000000000000000111000000100000000001100000000011111110000000000000000000000000000000000000010000000000000000000000000000000000000000000000000001100011100000000000000000000000000000000000000003
3000000011000000000011100110000000000000110000000000000000001111000000000000000000000000000000000000000000000000000000000000000000000000000000000000110000000011110000000000000000000000000000111000023
3333333333333333333333333333333333333333333333333333333333333333333333333333333333333333333333333333333333333333333333333333333333333333333333333333333333333333333333333333333333333333333333333333333