10 237
33333333333333333333333333333333333333333333333333333333333333333333333333333333333333333333333333333333333333333333333333333333333333333333333333333333333333333333333333333333333333333333333333333333333333333333333333333333333333333333                             
30100000000000000000000000001100000000000000000000000000000000000000001000000000000000001000000000000000000000000000000000000000011100000000000000000000000000000000000000000000000000000000000000000000000000000000000000000000000000000003
30100000000000000000000000000100000000000000000000000000000000000000001000000000000000001000000000000000000000000000000000001111111111110000000000000000000000000001111111110000000000000000000000000000000000000000000000000000000000001113
31000000000000000000000000000000000000000000000000000000000000000000000001000000000000001000000000000000000000000000000000000011111100000000000000000000000000000011111000000000000000000000011111111111111111000000000000000000000000001003
31000000000000000000000000000000000000000001111000000000000000000000000000000000000000000001000000000000000000000011101000000000000000000000000000000000000000000000000000000000000011111111111111111111111111111111100000000000000000001003
31000000000000000000000000000000000000000011100011000000000000000000000100000000000000000000100001000000000000000011100000000000000000000000000000000000000000000000000000000000000000000011111111111111111111100000000000000000000000000003
30000000000000000000000000000000000000011100000001100000000000000000000000000010000000000000001000000000000000000000000000000000000000000000000000111000000000000000000000000000000000000000000000000000000000000000000000000000000000000003
30000000000000000000000000000000000000000000000000000000000000000000000000000000000000000000000000000000000000000000000000000000000000000000000000000000000000000000000000000000000000000000000000000000000000000000000000000000000000001003
30000000000000000000000000000000000000000000000000000000000000000000000000000000000000000000000000000000000000000000000000000000000000000000000000000000000000000011111111111111100000000000000000000000000000000000000000000000000000001003   
33333333333333333333333333333333333333333333333333333333333333333333333333333333333333333333333333333333333333333333333333333333333333333333333333333333333333333333333333333333333333333333333333333333333333333333333333333333333333333333